%%%%%%
%  P %
%   G%
%.G. %
%.G. %
%%%%%%